Afrikaans	Veels geluk met jou verjaarsdag!
Albanian	Urime ditelindjen!
Arabic	    Eid milaad saeed! or Kul sana wa inta/i tayeb/a!
Armenian	Taredartzet shnorhavor!
Assyrian	Eida D’moladukh Hawee Brikha!
Austrian-Viennese	Ois guade winsch i dia zum Gbuadsdog!
Bengali	    Shuvo Jonmodin!
Brazil	    Parabens a voce
Bulgarian	Chestit Rojden Den!
Cambodian	Som owie nek mein aryouk yrinyu!
Chinese Cantonese	Sun Yat Fai Lok!
Chinese Fuzhou	  San Ni Kuai Lo!
Chinese Hakka	   Sang Ngit Fai Lok!
Chinese Mandarin	qu ni sheng er kuai le
Croatian	Sretan Rodendan!
Czech	Vsechno nejlepsi k Tvym narozeninam!!
Danish	Tillykke med fodselsdagen!
Dutch	Hartelijk gefeliciteerd!
English	Happy Birthday!
Estonian	Palju onne sunnipaevaks!
Farsi	Tavalodet Mobarak!
Finnish	Hyvaa syntymapaivaa!
French Canada	Bonne Fete!
French	Joyeux Anniversaire!
Georgian	Gilotcav dabadebis dges!
German	Alles Gute zum Geburtstag!
Greek	Eytyxismena Genethlia!
Hawaiian	Hau`oli la hanau!
Hebrew	Yom Huledet Same’ach!
Hiligaynon (Philippines)	Masadya gid nga adlaw sa imo pagkatawo!
Hindi (India)	Janam Din ki badhai!
Hungarian	Boldog szuletesnapot!
Icelandic	Til hamingju med afmaelisdaginn!
Indonesian	Selamat Ulang Tahun!
Italian	Buon Compleanno!
Italian (Piedmont)	Bun Cumpleani!
Japanese	Otanjou-bi Omedetou Gozaimasu!
Korean	Saeng il chuk ha ham ni da!
Kurdish	Rojbun a te piroz be!
Latin	Fortuna dies natalis!
Latvian	Daudz laimes dzimsanas diena!
Lithuanian	Sveikinu su gimtadieniu!
Luganda	Nkwagaliza amazalibwa go amalungi!
Macedonian	Sreken roden den!